#############################
#S....,,,,,,,,,,,,,,,,,,,,..#
#.####.###################.#
#....#.....~~~~~~~........#
####.#.#####~~~~~~~.######.
#....#.....~~~~~~~...#....#
#.####.###############.#..#
#....#...............#..##
#.#####################..##
#.............,,,,,,,,,...#
#########################G#
