#########################
#S....,,,,.....#########
#.####.#######.#........#
#....#.....~~~.#.######.
####.#.#####~~~.#.#....#
#....#.....~~~...#.#.###
#.####.############.#.#
#....#..............#.#
#.####################.#
#...................#..#
#####################G##
