###############################
#S....###########.....,,,,,,,#
#.###.#.........#.#####.###..#
#...#.#.#######.#.....#...#.#
###.#.#.#.....#.#.###.###.#.#
#.....#.#.###.#.#...#.....#.#
#.#####.#.#.#.#.###.#######.#
#.......#.#.#.#.....#.......#
#####################.#######
#.....................,,,,,G#
###############################
