#################################
#S....,,,,,,,,,,,,,,,,,,,,,,....#
#.####.########################.#
#....#.....~~~~~~~.............#
####.#.#####~~~~~~~.############
#....#.....~~~~~~~...#.........#
#.####.###############.#.#####.#
#....#...............#.#.....##
#.#####################.#.###.##
#.............,,,,,,,,,...#...G#
#################################
