###############################
#S....###########...,..~...,G#
#..##.#.........#.#####.###..#
#...#...#######.,.....,...#.#
###.#.#.#.....#.#.###.###.#.#
#.....#.#.###.#.#...#.....#.#
#.#####.#.#.#.#.###.#######.#
#.......#.#.#.#.....#.......#
#####.,##############.#######
#............~........,,,,,.#
###############################
