########################################
#S.....#.............#.................#
#.#####.#.#########.#.###############.#
#.....#.#.#.......#.#.#.............#.#
#####.#.#.#.#####.#.#.#.###########.#.#
#.....#.#.#.....#.#.#.#.#.........#.#.#
#.#####.#.#####.#.#.#.#.#.#########.#.#
#.#.....#.....#.#.#.#.#.#.....#.....#.#
#.#.#########.#.#.#.#.#####.#.#####.#.#
#.#...........#.#.#.#.....#.#.....#.#.#
#.#############.#.#.#####.#.#####.#.#.#
#...............#.#.......#.......#.#.#
###############.#.###########.#######.#.#
#...............#.............#.......#
#.#############################.########
#.....................................#
#####################################G#
########################################
