LABERINTO_DEFAULT = """
#####################
#S....#.........#...#
#.##.#.#.#####.#.#.##
#.#..#.#.....#.#.#.##
#.#.##.###.#.#.#.#.##
#.#......#.#.#...#.##
#.#.####.#.#.#####.##
#.#.#..#.#.#.....#.##
#...#..#...#.###.#.##
###.#######.#...#..##
#...#.....#.#.#.##.##
#.###.###.#.#.#...###
#...#...#.#...#.....#
###.#.#.#.#####.##.##
#...#.#.#.....#...###
#.###.#.###.#.###..##
#.....#.....#....G.##
#####################
""".strip("\n")

Hola como estas 
PRUEBA PARA SUBIR 