#########################
#S...~~~~~.....,,,,,,,##
#.##..#####.##########.
#...#.....#...........##
###.#.###.#.#.##########
#.....,...#.#,,,,,,,,,#
#.#####.#.#.############
#.......#.#...........#
##.##################.#
#...G.................#
########################
