##########
#S......#
#.######.
#......#.
######.#.
#....#..#
#.##.##.#
#....#G.#
##########
