############################################
#S...............#.........................#
#.#############.#.#.#####################.#
#.#...........#.#.#.#...................#.#
#.#.#########.#.#.#.#.#################.#.#
#.#.#.......#.#.#.#.#.#...............#.#.#
#.#.#.#####.#.#.#.#.#.#.#############.#.#.#
#.#.#.#.....#.#.#.#.#.#.#.............#.#.#
#.#.#.#.#####.#.#.#.#.#.#.#############.#.#
#.#.#.#.......#.#.#.#.#.#...............#.#
#.#.#.###########.#.#.#.#################.#
#.#.#.............#.#.#...................#
#.#.###############.#.###################.#
#.#.................#.....................#
#.#############################.############
#...............................#..........#
###############################.#.##########
#...............................#.........G#
############################################
