###########################
#S.....###################
#####.#..................#
#.....#.#################
#.#####.#...............##
#.#.....#########.#######
#.#.#############.#.....#
#.#...............#.###.#
#.#################.#.#.#
#.................#...#.#
###################.###.#
#.......................G#
###########################
